0000000000000000000 
000             000 
002             200 
0                 0 
0                 0 
0        2        0 
0        1        0 
0                 0 
0                 0 
0                 0 
0        3        0 
0                 0 
002             200 
000             000 
0000000000000000000 
